level,cr,ac,str.save.mod,dex.save.mod,con.save.mod,int.save.mod,wis.save.mod,cha.save.mod
1,1,13,1,1,1,-1,1,-1
2,2,14,1,2,2,-1,1,0
3,3,14,2,2,2,0,1,0
4,4,15,2,2,3,0,1,1
5,5,15,3,2,3,0,2,1
6,6,15,3,2,3,1,2,1
7,7,16,3,2,4,1,2,1
8,8,16,4,2,4,1,3,2
9,9,16,4,2,5,2,4,2
10,10,16,4,3,6,2,4,3
11,11,17,5,3,6,2,5,3
12,12,17,5,3,6,3,5,4
13,13,17,5,3,7,3,5,5
14,14,17,5,4,7,3,6,5
15,15,18,6,4,7,3,6,6
16,16,18,6,5,8,3,7,6
17,17,18,6,5,8,4,8,7
18,18,19,6,5,9,4,8,8
19,19,19,7,5,10,4,8,8
20,20,19,7,6,11,4,9,8
